###############
#E  # # #     #
### ###       #
##  # # ###   #
# #           #
# # #         #
# # ## # #    #
## #          #
# ##         S#
###############