##########
#E    # ##
# #  #  ##
# #   ## #
#     ## #
#   ##   #
#  #    ##
#    #   #
###  ###S#
##########